||||||||||||||||||||||||||||||
|M             |||     |||||||
| |||||||| ||| ||||||| |||||||
|   ||     ||||||||        |||
| |||| ||||||||||||||| |||||||
|||||                      |||
|| || ||||||||| ||| ||||||||||
|| || ||||||||| ||| ||||||| ||
|| || ||               |||| ||
|| || || ||||||||||||| |||| ||
||    ||     C||||||||    | ||
||| |||| ||||||||||||| |||| ||
||| ||||               ||   ||
||| ||||||| ||| |||||||||   ||
|||         |||             ||
||||||||||||||| ||||||||||||||
|||||                      |||
||||||| ||||||| |||||||||| |||
|       ||||||| |||||      |||
||||||||||||||||||||||||||||||