||||||||||||||||||||||||||||||
|M         |||||||     |||||||
|||||||||| ||||||||||| |||||||
||||||     ||||||||        |||
|||||| ||||||||||||||| |||||||
|||||                      |||
|| || ||||||||| ||||||||||||||
|| || ||||||||| ||||||||||||||
|| || ||               |||||||
|| || || ||||||||||||| |||||||
||    ||      ||||||||    ||||
||| |||| ||||||||||||| |||||||
||| ||||               |||||||
||| ||||||||||| ||||||||||||||
|||    |||||||| ||||||||||||||
||||||||||||||| ||||||||||||||
|||||                      |||
||||||| ||||||| |||||||||| |||
|       ||||||| |||||C     |||
||||||||||||||||||||||||||||||